{
    "Algorithm": [
        "CSC505",
        "CSC541",
        "CSC562",
        "CSC565",
        "CSC568",
        "CSC579",
        "CSC580",
        "CSC583",
        "CSC584",
        "CSC714",
        "CSC724",
        "CSC762",
        "CSC766"
    ],
    "Data Science": [
        "CSC503",
        "CSC505",
        "CSC522",
        "CSC519",
        "CSC520",
        "CSC540",
        "CSC546",
        "CSC555",
        "CSC582",
        "CSC584",
        "CSC591",
        "CSC707",
        "CSC711",
        "CSC720",
        "CSC722",
        "CSC750",
        "CSC761",
        "CSC791"
    ],
    "Hardware": [
        "CSC506",
        "CSC548",
        "CSC563",
        "CSC573",
        "CSC576",
        "CSC577",
        "CSC583",
        "CSC766",
        "CSC775",
        "CSC776"
    ],
    "Networking": [
        "CSC513",
        "CSC570",
        "CSC573",
        "CSC574",
        "CSC575",
        "CSC576",
        "CSC577",
        "CSC743",
        "CSC772",
        "CSC773",
        "CSC774",
        "CSC775",
        "CSC776",
        "CSC777"
    ],
    "Software Engineering": [
        "CSC501",
        "CSC510",
        "CSC512",
        "CSC513",
        "CSC522",
        "CSC540",
        "CSC695",
        "CSC515",
        "CSC517",
        "CSC519",
        "CSC547",
        "CSC554",
        "CSC561",
        "CSC562",
        "CSC570",
        "CSC575",
        "CSC630",
        "CSC693",
        "CSC705",
        "CSC895",
        "CSC710",
        "CSC711",
        "CSC712",
        "CSC742",
        "CSC743",
        "CSC772",
        "CSC773",
        "CSC777"
    ],
    "Systems": [
        "CSC501",
        "CSC503",
        "CSC506",
        "CSC512",
        "CSC530",
        "CSC540",
        "CSC695",
        "CSC515",
        "CSC517",
        "CSC520",
        "CSC541",
        "CSC546",
        "CSC547",
        "CSC548",
        "CSC554",
        "CSC555",
        "CSC561",
        "CSC563",
        "CSC568",
        "CSC574",
        "CSC580",
        "CSC582",
        "CSC591",
        "CSC600",
        "CSC630",
        "CSC685",
        "CSC688",
        "CSC689",
        "CSC690",
        "CSC693",
        "CSC696",
        "CSC699",
        "CSC705",
        "CSC707",
        "CSC895",
        "CSC712",
        "CSC714",
        "CSC720",
        "CSC722",
        "CSC724",
        "CSC742",
        "CSC750",
        "CSC761",
        "CSC762",
        "CSC772",
        "CSC774",
        "CSC776",
        "CSC780",
        "CSC791"
    ]
}